0 0 0 0 n i i i i i i i i i n 0 0 0 0 0
0 0 0 0 n i n n n n n n n i n 0 0 0 0 0
0 0 0 s n i n 0 0 0 0 0 n i n 0 0 0 0 0
0 0 0 s n i n 0 0 0 0 0 n i n 0 0 0 0 0
0 0 0 s n i n 0 0 0 0 0 n i n 0 0 0 0 0
0 0 0 s n i n 0 0 0 0 0 n i n 0 0 0 0 0 
0 0 0 s n i n n n 0 n n n i n 0 0 0 0 0
0 0 0 s n i i i i 0 i i i i s 0 0 0 0 b
0 0 0 0 0 0 0 0 0 0 0 0 0 0 0 0 0 0 0 0
0 0 0 0 0 0 0 0 0 0 0 0 0 0 0 0 0 0 0 0
