b b b b b b 0 0 0 0 0 0 0 0 b b b b b b
b c s s s b 0 0 0 0 0 0 0 0 b s s s c b
b 0 b b 0 b 0 0 0 0 0 0 0 0 b 0 b b 0 b
b 0 b n 0 0 0 0 0 0 0 0 0 0 0 0 n b 0 b
b 0 b n 0 0 0 0 0 0 0 0 0 0 0 0 n b 0 b
b 0 b b 0 b 0 0 0 0 0 0 0 0 b 0 b b 0 b
b s s s s b 0 0 0 0 0 0 0 0 b s s s s b
b b b b b b 0 0 0 0 0 0 0 0 b b b b b b
0 0 0 0 0 0 0 0 0 0 0 0 0 0 0 0 0 0 0 0
0 0 0 0 0 0 0 0 0 0 0 0 0 0 0 0 0 0 0 0