0 0 0 0 0 0 0 0 0 0 0 0 0 0 0 0 0 0 0 0
0 0 0 0 0 i 0 0 0 0 0 0 i 0 0 0 0 0 0 0
0 0 0 0 0 i 0 0 0 0 0 0 i 0 0 0 0 0 0 0
0 0 0 0 0 0 0 0 0 0 0 0 0 0 0 0 0 0 0 0
c 0 0 0 0 0 0 0 0 0 0 0 0 0 0 0 0 0 0 c
0 i 0 0 0 0 0 0 0 0 0 0 0 0 0 0 0 0 i 0
0 0 i i i 0 0 0 0 0 0 0 0 0 0 i i i 0 0
0 0 0 0 0 0 0 0 0 0 0 0 0 0 0 0 0 0 0 0