0 0 0 0 0 s s s 0 0 0 s s s 0 0 0 0 0 0
0 0 0 s s i i i 0 0 0 i i i s s 0 0 0 0
0 0 s i g g g g 0 0 0 g g g g i s 0 0 0
0 s i g d d d d 0 0 0 d d d d g i s 0 0
s i g d b b b b 0 0 0 b b b b g i s 0 0
0 s i g d d d d 0 0 0 d d d d g i s 0 0
0 0 s i g g g g 0 0 0 g g g g i s 0 0 0
0 0 0 s s i i i 0 0 0 i i i s s 0 0 0 0
0 0 0 0 0 0 0 0 0 0 0 0 0 0 0 0 0 0 0 0
0 0 0 0 0 0 0 0 0 0 0 0 0 0 0 0 0 0 0 0