0 0 b 0 0 d d 0 n n n n 0 d d 0 0 b 0 0
0 b n 0 0 d d 0 n n n n 0 d d 0 0 n b 0
b n 0 0 0 0 0 i i b b i i 0 0 0 0 0 n b
b 0 0 0 0 i i g g c c g g i i 0 0 0 0 b
b 0 0 0 0 i i g g c c g g i i 0 0 0 0 b
b n 0 0 0 0 0 i i b b i i 0 0 0 0 0 n b
0 b n 0 0 d d 0 n n n n 0 d d 0 0 n b 0
0 0 b 0 0 d d 0 n n n n 0 d d 0 0 b 0 0
0 0 0 0 0 0 0 0 0 0 0 0 0 0 0 0 0 0 0 0
0 0 0 0 0 0 0 0 0 0 0 0 0 0 0 0 0 0 0 0