0 0 0 0 0 0 0 0 d d d d d 0 0 0 0 0 0 0
0 0 0 0 0 0 0 d d d d d d d 0 0 0 0 0 0
0 0 0 0 0 0 n n n d d d d d 0 0 0 0 0 0
0 0 0 0 0 0 n n n d d d d d 0 0 0 0 0 0 
0 0 0 0 0 0 0 d d d d d d d 0 0 0 0 0 0
0 0 0 0 0 0 0 d d d d d d d 0 0 0 0 0 0
0 0 0 0 0 0 0 d d 0 0 d d 0 0 0 0 0 0 0
0 0 0 0 0 0 0 d d 0 0 d d 0 0 0 0 0 0 0
