0 0 0 0 0 0 0 0 0 d d 0 0 0 0 0 0 0 0 0
0 0 0 0 0 0 0 0 0 d d 0 0 0 0 0 0 0 0 0
0 0 0 0 0 0 0 0 0 d d 0 0 0 0 0 0 0 0 0
0 0 0 0 0 0 0 0 d g g d 0 0 0 0 0 0 0 0
0 0 0 0 0 0 0 i i i i i i 0 0 0 0 0 0 0
0 0 0 0 0 0 0 0 0 c c 0 0 0 0 0 0 0 0 0
0 0 0 0 0 0 0 0 0 s s 0 0 0 0 0 0 0 0 0
0 0 0 0 0 0 0 0 0 s s 0 0 0 0 0 0 0 0 0