0 0 0 0 0 0 0 0 0 0 0 0 0 0 0 0 0 0 0 0
g g g g g g g g g g g g g g g g g g g g
0 i i i i i i i i i i i i i i i i i i 0
0 0 s s s s s s s s s s s s s s s s 0 0
0 0 0 s s s s s s s s s s s s s s 0 0 0
0 0 0 0 s s s s s s s s s s s s 0 0 0 0
0 0 0 0 0 s s s s s s s s s s 0 0 0 0 0
0 0 0 0 0 0 s s s s s s s s 0 0 0 0 0 0