0 0 0 0 0 s 0 0 s 0 0 s 0 0 s 0 0 0 0 0
0 0 0 s 0 0 i 0 0 i 0 0 i 0 0 s 0 0 0 0
0 0 g 0 0 0 0 g 0 0 g 0 0 0 0 g 0 0 0 0
0 d 0 0 0 b 0 0 d 0 0 d 0 0 b 0 0 0 d 0
n 0 0 0 d 0 0 b 0 0 b 0 0 d 0 0 0 0 0 n
0 d 0 0 0 b 0 0 d 0 0 d 0 0 b 0 0 0 d 0
0 0 g 0 0 0 0 g 0 0 g 0 0 0 0 g 0 0 0 0
0 0 0 s 0 0 i 0 0 i 0 0 i 0 0 s 0 0 0 0
0 0 0 0 0 0 0 0 0 0 0 0 0 0 0 0 0 0 0 0
0 0 0 0 0 0 0 0 0 0 0 0 0 0 0 0 0 0 0 0