0 0 0 0 0 0 0 0 0 0 0 0 0 0 0 0 0 0 0 0
0 i 0 i 0 i 0 i 0 i 0 i 0 i 0 i 0 i 0 i
i i i i i i i i i i i i i i i i i i i i
0 i 0 i 0 i 0 i 0 i 0 i 0 i 0 i 0 i 0 i
s s s s s s s s s s s s s s s s s s s s
0 s 0 s 0 s 0 s 0 s 0 s 0 s 0 s 0 s 0 s
s s s s s s s s s s s s s s s s s s s s
0 0 0 0 0 0 0 0 0 0 0 0 0 0 0 0 0 0 0 0