d 0 0 0 0 0 0 i i 0 0 i i 0 0 0 0 0 0 d
0 d 0 0 0 0 i 0 0 0 0 0 0 i 0 0 0 0 d 0
0 0 d 0 0 i 0 0 0 c c 0 0 0 i 0 0 d 0 0
0 0 0 n i 0 0 0 0 c c 0 0 0 0 i n 0 0 0
0 0 0 n i 0 0 0 0 c c 0 0 0 0 i n 0 0 0
0 0 d 0 0 i 0 0 0 c c 0 0 0 i 0 0 d 0 0
0 d 0 0 0 0 i 0 0 0 0 0 0 i 0 0 0 0 d 0
d 0 0 0 0 0 0 i i 0 0 i i 0 0 0 0 0 0 d
0 0 0 0 0 0 0 0 0 0 0 0 0 0 0 0 0 0 0 0
0 0 0 0 0 0 0 0 0 0 0 0 0 0 0 0 0 0 0 0