0 0 0 0 g g g g g g g g g g 0 0 0 0 0 0
0 0 0 0 g n n g g g g n n g 0 0 0 0 0 0
0 0 0 0 g n n g g g g n n g 0 0 0 0 0 0
0 0 0 0 g 0 0 n n n n 0 0 g 0 0 0 0 0 0
0 0 0 0 g 0 0 n c c n 0 0 g 0 0 0 0 0 0
0 0 0 0 g 0 0 n 0 0 n 0 0 g 0 0 0 0 0 0
0 0 0 0 g g g g g g g g g g 0 0 0 0 0 0
0 0 0 0 0 0 0 0 0 0 0 0 0 0 0 0 0 0 0 0
0 0 0 0 0 0 0 0 0 0 0 0 0 0 0 0 0 0 0 0
0 0 0 0 0 0 0 0 0 0 0 0 0 0 0 0 0 0 0 0