0 0 s s s s s 0 0 0 0 0 0 s s s s s 0 0
0 s i i i i i s 0 0 0 0 s i i i i i s 0
s i g g g g g i s 0 0 s i g g g g g i s
0 0 g d d d d g 0 0 0 0 g d d d d g 0 0
0 0 0 b b b b 0 0 0 0 0 0 b b b b 0 0 0
0 0 0 g d d d g 0 0 0 0 g d d d g 0 0 0
0 0 0 0 g g g 0 0 0 0 0 g g g 0 0 0 0 0
0 0 0 0 0 s 0 0 0 0 0 0 0 s 0 0 0 0 0 0
0 0 0 0 0 0 0 0 0 0 0 0 0 0 0 0 0 0 0 0
0 0 0 0 0 0 0 0 0 0 0 0 0 0 0 0 0 0 0 0