0 n 0 0 0 0 0 0 0 0 0 0 0 0 0 0 0 0 n 0
0 n n 0 0 0 0 0 0 0 0 0 0 0 0 0 0 n n 0
0 n g 0 0 0 0 b b 0 0 b b 0 0 0 0 g n 0
0 n g 0 0 0 0 b c 0 0 c b 0 0 0 0 g n 0
0 n g 0 0 0 0 b c 0 0 c b 0 0 0 0 g n 0
0 n g 0 0 0 0 b b 0 0 b b 0 0 0 0 g n 0
0 n n 0 0 0 0 0 0 0 0 0 0 0 0 0 0 n n 0
b b 0 0 0 0 0 0 0 0 0 0 0 0 0 0 0 0 b b