0 0 0 0 0 0 0 0 0 0 0 0 0 0 0 0 0 0 0 0
0 0 0 0 0 0 0 0 0 0 0 0 0 0 0 0 0 0 0 0
0 0 0 0 0 0 0 0 0 0 0 0 0 0 0 0 0 0 0 0
0 0 0 0 0 0 s s 0 0 0 0 s s 0 0 0 0 0 0
0 0 0 0 0 0 s c s 0 0 s c s 0 0 0 0 0 0
0 0 0 0 0 0 0 s s s s s s 0 0 0 0 0 0 0
0 0 0 0 0 0 0 0 0 s s 0 0 0 0 0 0 0 0 0
0 0 0 0 0 0 0 0 0 0 0 0 0 0 0 0 0 0 0 0