0 0 0 0 0 0 0 0 i i 0 0 0 0 0 0 0 0 0 0
0 0 0 0 0 0 0 i 0 0 i 0 0 0 0 0 0 0 0 0
0 0 0 0 0 0 i g g g g i c 0 0 0 0 0 0 0
0 0 0 0 0 0 i g g g g i c 0 0 0 0 0 0 0
0 0 0 0 0 0 i i i i i i 0 0 0 0 0 0 0 0
0 0 0 0 0 0 0 i 0 0 i 0 0 0 0 0 0 0 0 0
0 0 0 0 0 0 0 i 0 0 i 0 0 0 0 0 0 0 0 0
0 0 0 0 0 0 0 0 0 0 0 0 0 0 0 0 0 0 0 0
0 0 0 0 0 0 0 0 0 0 0 0 0 0 0 0 0 0 0 0
0 0 0 0 0 0 0 0 0 0 0 0 0 0 0 0 0 0 0 0