b b b b b b b b b b b b b b b b b b b b
b n 0 n 0 n 0 n 0 n 0 n 0 0 0 0 0 0 0 b
b 0 0 0 0 0 0 0 0 0 0 0 0 0 0 0 0 0 0 b
b 0 0 0 0 0 0 0 0 0 0 0 0 0 0 0 b 0 0 b
b 0 0 0 0 0 0 0 0 0 0 0 0 0 0 0 b 0 0 b 
b 0 0 0 0 0 0 0 0 0 0 0 0 0 0 0 b 0 0 b 
b 0 g 0 g 0 g 0 g 0 g 0 g 0 g 0 b b 0 b
b 0 0 0 0 0 0 0 0 0 0 0 0 0 0 0 b b 0 b
b 0 d 0 d 0 d 0 d 0 d 0 d 0 d 0 b b 0 b
b b b b b b b b b b b b b b b b b b 0 b
